*********S**
*          *
*   *****  *
*   * E *  *
*          *
************