|-------S--|
|          |
|   |---|  |
|   | E |  |
|          |
|----------|