**S**************
*       ******  *
*   *           *
*   ****  *     *
*         ****  *
*******         *
*               E
*****************