|-S-------------|
|               |
|  |--|  ----|  |
|  |  |      |  |
|         |     |
|---------|  ---|
|               E
|---------------|
