**S******************
*  *   *  *   *     *
*         * ***  **** 
******* * * *    *  * 
*    **   * ***  *  * 
*  **               *
*        ***   ****** 
*  *****  *      *  *
*         *         *
**E******************