****************E*******
*  *     *     *  **   * 
*  ****  *  ****  ***  * 
*     *  *  *       *  * 
*  ****     *  **  **  * 
*    *   * ***     *   * 
*  ***   *       ***   * 
*  *** * ****  ***     * 
*                   ****
*   ******  *   *   *  *
*****           *   *  *
S   ******  *   *****  *
*           *          *
************************