*S*****************************E*
* *   *       *****     *       *
* *** *** * *     * * ***** *****
*     *   ******  * *     * *   *
*** * *** * *     * ******* *** *
*   *     ***** * ***  *    * * *
* * ***   *     *   *  * *      *
* * *   * * * *** * *  * ********  
* ******* * *     *    *        *
* * *** * * * *** * ********  * *
* * * ***** *  *  *      *    * *
*                 ****   *   ** *
*******  ********    *   ***  * *
* **     *  *   ******   * *  * *
* *****  *               *      *
* *      *************  ******* *
* *****  *                *     *
*  ** *  *****  ******  *****  **
*                   **          *
*********************************