|S-----------------------------E|
| |   |     |     |     |       |
| |-- | --| |     | | --| | |---|
|     |   |-|---  | |     | |   |
|-- | |-- | |     | |--|--| |-| |
|   |     |---- | |-|  |    | | |
| | |--   |     |   |  | |      |
| | |   | | | --| | |  | |------|  
| |-|---| | |     |    |        |
| | |   | | | -|- | ---|-|--  | |
| | | --| |-|  |  |      |    | |
|                 |--|   | |--| |
|-|---|  |--|---|    |   |-|  | |
| |   |  |  |   |  |-|   | |  | |
|    -|         |  |     |      |
| |      |  |- -|  |--  -|---|  |
| |---|  |  |                   |
| |   |  |--|- -|--|-|  |--|  --|
|     |              |          |
|-------------------------------|